11111111111111111111111111111111111119
10000000000000100000000000001000000019
10101011111111111010111111111111111019
10101000100000001010000000001000000019
10101111101111101010111111101011101019
10100000001010101010101000100010101019
10101111111010101010101010111110101019
10101000000010101010101010000010101019
10101111111010101110101010111110101019
10100000000000100000000010000000101019
10111111111111101111111111111111101119
10000010100000001010000000000000101019
11101010101111111011111010111111101019
10001010001000000000101010000000001019
11111010111111111110101010101111111019
10000010101000000000101010100000000019
10111110101011111110101010101111101019
10100000101010000010100010100000101019
10111111101010111010111110101111101019
10000000001010100010000000101000001019
11111110111010101011111111101011111019
10000010001010101000001000001010001019
10111111111010101111101111111010101019
10100000000010100000100000000010101019
10101011111011111111101111111110111019
10001010001010000000101010100000000019
10101010101010111010101010101110111119
10101010100010101010101010100010100019
10111010111110101010101010101010101119
10001010000010100010100010001010000019
11101011111110101010111111111111111119
10101010000010101010001010000000000019
10101010111110101110101010111111101019
10101010000010101010100010100000101019
10111011111010101010111110111110101019
10000000000000100010000000000000101019
11101111111011111011111111111110101019
10101000000010000000100000100000101019
10101111111111111110101110111110101019
10100010000000001010100010000000101019
10101010111111101010111111111111101019
10001010101000101000001000000000001019
10111110101010101111111011111111101119
10101000101010100000000010100000101019
10101011101010111111111010101110101019
10100010000010000000000010001000000019
11111111111111111111111111111111111119