11111111111111111111111
10100000000000001010101
10111110101111111010101
10101000100010101010101
10101011111010101010101
10000011100010000010101
10101011101110111010101
10101000100000001010001
11111111101111111010101
10100000000000101010101
10101111111110101010111
10100000001000001010001
10111111111011111010111
10000000000000001000001
11111111111111111110111
10000000000000101010001
10111111111110101010101
10100000000000100000101
10111111101111101010111
10100000000000001010001
10111111111111111010001
10000000000000001010001
11111111111111111111111