11111111111111111111111
10100000000000001010101
10111110101110111010101
10101000100010101000001
10101000001010101010101
10000000100010000010101
10101001101110111010101
10101000100000001010001
11111101101110111000101
10100000000000101010101
10101101111110101010111
10100000001000000010001
10111101111011101010111
10000000000000001000001
11111101110111101110111
10000000000000101010001
10111111011110101010101
10000000000000100000101
10111111101111101010111
10000000000000001010001
10111011111101111010001
10000000000000001010001
11111111111111111111111